11
###########
#         #
# ....... #
#S.     . #
#   ... . #
#   . . . #
# ... ... #
# .       #
# .......E#
#         #
###########